000 000 000 000 000 000 000 000 000 000 000 000 000 000 000 000 000 000 000 000
000 100 200 200 200 200 200 000 201 201 201 201 201 000 202 202 101 203 203 000
000 000 000 000 000 000 200 000 201 000 000 000 201 000 102 000 204 000 203 000
000 103 000 205 205 205 104 201 201 000 201 201 201 000 000 000 204 000 203 000
000 205 000 205 000 000 206 000 000 000 201 000 000 000 207 207 105 000 203 000
000 205 205 205 000 206 206 000 208 208 106 209 209 209 107 000 210 000 203 000
000 000 000 000 000 206 000 000 208 000 000 000 000 000 211 000 210 000 203 000
000 108 212 212 212 109 208 208 208 000 213 213 213 213 110 000 111 000 203 000
000 000 000 000 000 000 000 000 000 000 213 000 000 000 214 000 000 000 203 000
000 215 215 215 215 215 215 215 215 215 112 000 000 000 113 216 114 217 115 000
000 215 000 000 000 000 000 000 000 000 218 000 000 000 219 000 220 000 221 000
000 215 215 215 215 116 222 222 222 222 117 219 219 219 219 000 220 000 221 000
000 000 000 000 000 223 000 000 000 000 000 000 000 000 000 000 220 000 221 000
000 224 224 224 224 118 225 225 225 225 225 225 225 225 225 225 119 000 221 000
000 224 000 000 000 226 000 000 000 000 000 000 000 000 000 000 221 000 221 000
000 120 227 227 227 121 228 228 228 228 228 228 122 229 229 000 221 000 221 000
000 230 000 000 000 231 000 000 000 000 000 000 232 000 229 000 221 221 221 000
000 230 000 000 000 231 000 000 000 000 000 000 232 000 229 000 000 000 000 000
000 230 230 123 000 231 231 231 231 231 124 000 125 000 229 229 229 229 126 000
000 000 000 000 000 000 000 000 000 000 000 000 000 000 000 000 000 000 000 000